#..@......#....#.............#..!............#..#
#.........#...........!......#...............#..#
#.......%.#....#.............#.....#........*#A.#
###########...#########################...#######
#E..............#..!.......#.%...A.#.........A..#
#A..!.........................................%.#
#E.......*......#A.....*...#.....*.#..!.........#
#################################################